 R 600 600

 NO /home/guillaumeoz/Desktop/workingdir/42_cube3D/textures/xpm/MARBFACE.xpm

  SO /home/guillaumeoz/Desktop/workingdir/42_cube3D/textures/xpm/MARBFAC3.xpm
  WE /home/guillaumeoz/Desktop/workingdir/42_cube3D/textures/xpm/MARBFAC2.xpm
 EA  /home/guillaumeoz/Desktop/workingdir/42_cube3D/textures/xpm/MARBLE3.xpm


  S /home/guillaumeoz/Desktop/workingdir/42_cube3D/textures/xpm/BIGDOOR6.xpm


F   110,51,0




C  135,206,235


        1111111111111111111111111
        1000000000110000000000001
        1011000001110000002000001
        1001000000000000000000001
111111111011000001110000000000001
100000000011000001110111111111111
11110111111111011100000010001
11110111111111011100000000001
11000000110101011100000010001
10002000000000001100000010001
10000000000000001101010010001
11000001110101011111011110N0111
11110111 1110101 101111010001
11111111 1111111 111111111111