
NO ./textures/coal_ore.xpm
SO ./textures/emerald_ore.xpm
WE ./textures/redstone_ore.xpm
EA ./textures/iron_ore.xpm

F 220,100,0

C 225,30,0


   111111
  1111011111   
1111100001111111
1100000000000001
 110000000000011
  1000000000001
  1000000000001
  1000000000011
  1111011111111
     101
     101 111111
   11101 100001
   100N1 100001
   11101 100001
     101 100001
111  1011101111
101  1000001
111  1111111