R 700 550

        NO ./textures/wall_1.xpm
SO  ./textures/wall_2.xpm
 WE      ./textures/wall_3.xpm
EA ./textures/wall_4.xpm

D ./textures/door.xpm
M ./textures/alien.xpm ./textures/blood.xpm 15
L ./textures/end.xpm
S ./textures/pillar.xpm
F 155,118,83

H ./textures/medkit.xpm 30

      C      255,255,255

1111111111111111111111111111111111
10000010000100000000000000300030011
11011110110101101111101100100011001
10000100100001110001001111000111011
100010101131000000100100001000101001
111110101H01111111111111111111101101
100100001111000000000000000000000101
110100000001111111111111111111100101
100100M00001220100000000300000110101
101100000001220101111113100000010101
100000000011000100000020100000010101
100000000011000111111010100000110101
10M000M00011000100001010100000100101
100000000011000101101010100000111131
100000000011000101001000100000000001
100000002200200101011010100000000001
100000000200000101000010100000000001
100000000000111101111111100000111111
1000M00000001001000000000000001
1000000000001001000000000000001
100000M000001111000000000000001
1000000000000000000000000000001
1000000000000000000000000000001
100000000M000000000000000000111
100M000000000000000001112211101
1111111111100004000001000000001
111111111110000N0000010000000011111
111111111110000000000300000000000H1
11111111111000000000010000000011111
1111111111100000000001000000001
1111111111111111111111111111111