R 1000 700
NO ./textures/purplestone.xpm
SO ./textures/purplestone.xpm
WE ./textures/purplestone.xpm
EA ./textures/purplestone.xpm

D ./textures/purplestone.xpm
S ./textures/pillar.xpm
L ./textures/end.xpm
M ./textures/alien.xpm ./textures/blood.xpm 15
H ./textures/medkit.xpm 30

F 255,0,255
C 238,130,238

11111111111111111111111111111
100000000H1100000M00000000001
1011000001110000MMM0000010001
1E410000000000000M00000010001
10110000011100000000000H10001
10000000001100000111011112M21
11110111111111011100000010001
11110111111111011101010010001
11000000110101011100000010001
1000M000000000001100000010001
100000000000000011H1010010001
11000000110131011111011110001
111101111111H1011111011110001
11111111111111111111111111111