R  500 400

NO  ./textures/wall_1.xpm

SO  ./textures/wall_2.xpm

  WE      ./textures/wall_3.xpm
EA  ./textures/wall_4.xpm

S ./textures/pillar.xpm

F              155,118,83
      C      255,255,255


1111111111111
1000000000001
1020111110201
10001   10001
10001   10001
1020111110201
10000000000N1
1111111111111