R 1000000000 1000000000

        NO ./textures/wall_1.xpm
SO  ./textures/wall_2.xpm
 WE      ./textures/wall_3.xpm
EA ./textures/wall_4.xpm


D     ./textures/door.xpm
M ./textures/alien.xpm ./textures/blood.xpm 15
L    ./textures/wall_4.xpm
S ./textures/pillar.xpm
F              155,118,83

T

H ./textures/medkit.xpm 30

      C      255,255,255

11111
10001
10001
10001
11111
 
   111                111111111
   101      11        1000001111111111111111111
   111      11        10111000000003000M00M0MH1
                      1040111111113110M0000MMM1
1111111111111111111111111311111  1011000M00M001
1M000M00000000M0000000000M00001  100M0M0000M001
1002002M02002002002M02002002001111000M0M00MMMM1
10M000000000M0000000000000000M11H4M0M000M00MM01
11311111111111111111111111111111111111111111111
1000000000M0000001
1000M0000000000001
1111111111111111311111111111111
      1111222222M2222110M040111
      11112000M0000021111110111
      1H04000M00000021000000001
    1111112000M0000003000M00001
  11111111222222222221H0000000111111
        111111111111111111100000W001
                          11111111H1
                                 111