R  600 500

NO  ./textures/wall_1.xpm

SO  ./textures/wall_2.xpm

  WE      ./textures/wall_3.xpm
EA  ./textures/wall_4.xpm

S ./textures/pillar.xpm

F              155,118,83
      C      255,255,255


11111
10001
10201
10N01
11111